%%%%%%%%%%%%%%
%.    ..    .%
%.%%.%..%.%%.%
%............%
% %%%%%%%%%% %
%   13%%24   %
%%%%%%%%%%%%%%